61 H,H,H,K
55 H,K,H,K
66 K,K,H,K
43 H,K,H,H
72 H,K,K,K
62 H,K,K,H
72 K,H,H,H
69 H,H,K,H
71 H,H,K,K
61 K,H,H,K
57 H,H,H,H
58 K,H,K,K
66 K,K,K,H
53 K,K,K,K
59 K,K,H,H
75 K,H,K,H
