7 K,H,H,H
10 K,K,K,K
8 K,H,H,K
6 H,H,H,K
9 K,K,H,K
8 H,K,H,K
3 K,H,K,K
9 H,K,K,K
4 H,H,H,H
5 H,H,K,H
6 H,K,H,H
9 K,H,K,H
7 K,K,K,H
3 K,K,H,H
4 H,K,K,H
2 H,H,K,K
